1111111111111111111111111111
10C0101000011100000000000001
100000000000110000C000000001
100P000001000000010000000001
10000C0000001111000111100001
100000000000100000000E100011
1111111111111111111111111111
